#############
# P   X  O  #
#           #
#      ##   #
#       #   #
# OX    # O #
#       #   #
#    X  # O #
#       #   #
#   X   #   #
#           #
#############
